28 boss
27 gate to the boss
26 key
25 hp
24 item
23 tree
22 lava
21 monster

20 20 20 20 20 20 20 20 20 20 20 20 20 20 20 20 20 20 20 20 20 20 20 20 20 20 20 20 20 20 20 20 20 20 20 20 20 20 20 20 
20 20 20 20 20 20 20 20 20 20 20 20 20 20 20 20 20 20 20 20 20 20 20 20 20 20 20 20 20 20 20 20 20 20 20 20 20 20 20 20 
20 20 20          20 20 25                21                20 20 20 20          20 20 20 20 20 20 20 20    25    20 20
20 20                20 20 20 20 20 20 20 20                20 20 20       25       20 20 20 20 20 20 20          20 20
20 20                23                   20                20 20 20 20          21       20 20 20 20    21 20 20 20 20
20 20                20 20 20 20 20 20 21 20                20 20 20 20 20 20 20             20 20 20       20 20 20 20   
20 20                20 20 20             20                20 20 20 20 20 20 20 20 20 20       22       20 20 20 20 20
20 20 20             20 20                   20          20 20 20 20 20 20 20 20 20 20 20 20    22    20 20 20 20 20 20
20 20 20 20 20 20    20 20                      20 23 20 20                               20    22    20 20 20 20 20 20
20 20                21 20 20                         20 20             20    22 22 22    20                   20 20 20  
20 20       20 20 20 21    20 20                20 20 20                20                20                      20 20          
20             20 20 20       20 20             20 20 20                20    22 22 22    21                   20 20 20 
20                20 20 20       20 20 20       20 20                   20                20          20 21 20 20 20 20
20                20 20 20 20       20 20       23                      20    22 22 22    20       20 20    20 20 20 20
20 20          20 20       20 20 21 21 20 20 20    20 20 20             20                20    20 20 20    20 20 20 20
20 20 20    20 20             20 20          20    20 20 20 20 20 20 20 20    22 22 22    20 20 20 20 20    20 20 20 20 
20          20 20                20    24    20    20 20 20 20 20 20 20 20 20 20 20 20 20 20 20 20 20 20    20 20 20 20
20    20 20 20 20 20             20          20    20 20 20 20 20 20 20 20 20 20 20 20 20 20 20 20 20 20    20 20 20 20     
20             20 20 20    20 23 20 20 20 20 20    20 20 20 20 20 20 20 20 20 20 20 20 20 20 20 20 20 20    20 20 20 20
20 20 20 20    20          20                   23    20                21                                  20 20 20 20
20             20    25    20                   20    20                21                                  20 20 20 20
20    20 20 20 20          20                   20    20 23 20 20 20 20 20 20 20 20 20 20 20 20 20 20 20 20 20 20 20 20
20             20 21 21 20 20 22             22 20    20                20 20 20 20                                  20
20 20 20 20 21 20 20       20 20 22       22 20 20    20                   20 20 20    22 22 22 22 22 22 22 22 22    20
20 22 22       22 20          20 20       20 20       20 20                   20 20                                  20
20 22 22    22 22 20 20 21 21 20 20       20             20 20                22 20 20             22                20
20 22 22    22 22 20 20          20       20             21 21                22 20 20             22                20
20 22       22 20 20 22          20       20          20 20 20                22 20 20             22                20
20 22    22 22 20 22       22 20 20 21 21 20 20          20 20                      27       22 22 22 22 22          20 
20 22       22 20       22 20 20 22       22 20 20          20                22 20 20             22                20
20 20 20    20 20 20 23 20 20 22             22 20          20                22 20 20             22                20
20                20    20 20                22 20    21    20                22 20 20             22                20
20    20 20 20    20    20 20                22 20          20 20             20 20                                  20
20    20 20 20    20    20 20             22 20 20          20 20 25 26 25 20 20 22                               22 20
20                20    20 20          22 20 20 20 20          20 20 20 20 20 20 22                               22 20    
20 20 20    20 20 20    20 20       22 20 20 20 20 20 20    21    20 20 20 20 20 22          28 28 28 28          22 20 
20 20                   20 20       20 20 20 20 20 20 20 20          20 20 20 20 22          28 28 28 28          22 20
20             20 20 20 20 20 20 23 20 20 20 20 20 20 20 20 20 20    20 20 20 20 22          28 28 28 28          22 20 
20 20       20 20 20 20 20 20 20                                     20 20 20 20 22 22 22 22 22 22 22 22 22 22 22 22 20 
20 20 20 20 20 20 20 20 20 20 20 20 20 20 20 20 20 20 20 20 20 20 20 20 20 20 20 20 20 20 20 20 20 20 20 20 20 20 20 20 
20 20 20 20 20 20 20 20 20 20 20 20 20 20 20 20 20 20 20 20 20 20 20 20 20 20 20 20 20 20 20 20 20 20 20 20 20 20 20 20  
