24
24
20 20 20 20 20 20 20 20 20 20 20 20 20 20 20 20 20 20 20 20 20 20 20  1
20 20 20 20 20 20 20 20 20 20 20 20 20 20 20 20 20 20 20 20 20 20 20  1
20 20  1  1  1 20  1  1  1  1  1  1 20 20  1  1  1  1  1  1  1 20 20  1
20 20  1  1  1 20  1  1  1  1  1  1 20 20  1  1  1  1  1  1  1 20 20  1
20 20  1  1  1 20  1  1  1  1  1  1 20 20  1  1  1  1  1  1  1 20 20  1
20 20 20 20 20 20  1 20 20 20 20 20 20 20 20 20 20 20 20 20 20 20 20  1
20 20  1  1  1  1  1 20  1  1  1  1 20 20 20 20 20 20 20 20 20 20 20  1
20 20  1  1  1  1  1 20  1  1  1  4 20 20  1  1  1  1  1  1  1 20 20  1
20 20  1  1  1  1  1 20  1  1  1  4 20 20  1  1  1  1  1  1  1 20 20  1
20 20  1  1  1  1  1 20  4  4  1  1  1  1  1  1  1  1  4  4  1 20 20  1
20 20  1  1  1  1  1 20 20 20 20 20  1  1  1  1  1  1  1  4  1 20 20  1
20 20  1  1  1  1  1  1  1  1  1 20  1  1  1  1  1  1  1  4  1 20 20  1
20 20  4  4  4  1  1  1  1  1  1 20  1  1  1  1  1  1  4  4  1 20 20  1
20 20  1  1  1  1  1  1  1  1  1 20 20 20  1  1  1  1  1  1  1 20 20  1
20 20  4  4  4  1  1  1 20 20  1  1 20 20 21 20 20 20 20 20 20 20 20  1
20 20  1  1  1  1  1  1 20 20  1  1 20 20  1 20 20 20 20 20 20 20 20  1
20 20  1  1  1  1  1  1 20 20 21 20 20 20  1 20 20 20 20 20 20 20 20  1
20 20 20 20 20 20 20 20 20 20  1  1 20 20  1  1  1  1  1  1  1 20 20  1
20 20 20 20 20 20 20 20 20 20  1  1 20 20  1  1  1  1  1  1  1 20 20  1
20 20  4  4  1  1  1  1  1  1  1  1 20 20  1  1  1  1  1  1  1 20 20  1
20 20  1  1  1  1  1  1  1  1  1  1 20 20  1  1  1  1  1  1  1 20 20  1
20 20  1  1  1  1  1  1  1  1  1  1 20 20  1  1  1  1  1  1  1 20 20  1
20 20 20 20 20 20 20 20 20 20 20 20 20 20 20 20 20 20 20 20 20 20 20  1
 1  1  1  1  1  1  1  1  1  1  1  1  1  1  1  1  1  1  1  1  1  1  1  1
 1  1  1  1  1  1  1  1  1  1  1  1  1  1  1  1  1  1  1  1  1  1  1  1
 1  1  1  1  1  1  1  1  1  1  1  1  1  1  1  1  1  1  1  1  1  1  1  1
 1  1  1  1  1  1  1  1  1  1  1  1  1  1  1  1  1  1  1  1  1  1  1  1
 1  1  1  1  1  1  1  1  1  1  1  1  1  1  1  1  1  1  1  1  1  1  1  1