28 boss
27 gate to the boss
26 key
25 hp
24 item
23 tree
22 lava
21 monster

20 20 20 20 20 20 20 20 20 20 20 20 20 20 20 20 20 20 20 20 20 20 20 20 20 20 20 20 20 20 20 20 20 20 20 20 20 20 20 20 
20 20 20 20 20 20 20 20 20 20 20 20 20 20 20 20 20 20 20 20 20 20 20 20 20 20 20 20 20 20 20 20 20 20 20 20 20 20 20 20 
20 20 20 1  1  1  1  20 20 25 1  1  1  1  21 1  1  1  1  1  20 20 20 20 1  1  1  20 20 20 20 20 20 20 20 1  25 1  20 20
20 20 1  1  1  1  1  20 20 20 20 20 20 20 20 1  1  1  1  1  20 20 20 1  1  25 1  20 20 20 20 20 20 20 1  1  1  1  20 20
20 20 1  1  1  1  1  23 1  1  1  1  1  1  20 1  1  1  1  1  20 20 20 20 1  1  1  21 1  1  20 20 20 20 1  21 20 20 20 20
20 20 1  1  1  1  1  20 20 20 20 20 20 21 20 1  1  1  1  1  20 20 20 20 20 20 20 1  1  1  1  20 20 20 1  1  20 20 20 20   
20 20 1  1  1  1  1  20 20 20 1  1  1  1  20 1  1  1  1  1  20 20 20 20 20 20 20 20 20 20 1  1  22 1  1  20 20 20 20 20
20 20 20 1  1  1  1  20 20 1  1  1  1  1  1  20 1  1  1  20 20 20 20 20 20 20 20 20 20 20 20 1  22 1  20 20 20 20 20 20
20 20 20 20 20 20 1  20 20 1  1  1  1  1  1  1  20 23 20 20 1  1  1  1  1  1  1  1  1  1  20 1  22 1  20 20 20 20 20 20
20 20 1  1  1  1  1  21 20 20 1  1  1  1  1  1  1  1  20 20 1  1  1  1  20 1  22 22 22 1  20 1  1  1  1  1  1  20 20 20  
20 20 1  1  20 20 20 21 1  20 20 1  1  1  1  1  20 20 20 1  1  1  1  1  20 1  1  1  1  1  20 1  1  1  1  1  1  1  20 20          
20 1  1  1  1  20 20 20 1  1  20 20 1  1  1  1  20 20 20 1  1  1  1  1  20 1  22 22 22 1  21 1  1  1  1  1  1  20 20 20 
20 1  1  1  1  1  20 20 20 1  1  20 20 20 1  1  20 20 1  1  1  1  1  1  20 1  1  1  1  1  20 1  1  1  20 21 20 20 20 20
20 1  1  1  1  1  20 20 20 20 1  1  20 20 1  1  23 1  1  1  1  1  1  1  20 1  22 22 22 1  20 1  1  20 20 1  20 20 20 20
20 20 1  1  1  20 20 1  1  20 20 21 21 20 20 20 1  20 20 20 1  1  1  1  20 1  1  1  1  1  20 1  20 20 20 1  20 20 20 20
20 20 20 1  20 20 1  1  1  1  20 20 1  1  1  20 1  20 20 20 20 20 20 20 20 1  22 22 22 1  20 20 20 20 20 1  20 20 20 20 
20 1  1  1  20 20 1  1  1  1  1  20 1  24 1  20 1  20 20 20 20 20 20 20 20 20 20 20 20 20 20 20 20 20 20 1  20 20 20 20
20 1  20 20 20 20 20 1  1  1  1  20 1  1  1  20 1  20 20 20 20 20 20 20 20 20 20 20 20 20 20 20 20 20 20 1  20 20 20 20     
20 1  1  1  1  20 20 20 1  20 23 20 20 20 20 20 1  20 20 20 20 20 20 20 20 20 20 20 20 20 20 20 20 20 20 1  20 20 20 20
20 20 20 20 1  20 1  1  1  20 1  1  1  1  1  1  23 1  20 1  1  1  1  1  21 1  1  1  1  1  1  1  1  1  1  1  20 20 20 20
20 1  1  1  1  20 1  25 1  20 1  1  1  1  1  1  20 1  20 1  1  1  1  1  21 1  1  1  1  1  1  1  1  1  1  1  20 20 20 20
20 1  20 20 20 20 1  1  1  20 1  1  1  1  1  1  20 1  20 23 20 20 20 20 20 20 20 20 20 20 20 20 20 20 20 20 20 20 20 20
20 1  1  1  1  20 21 21 20 20 22 1  1  1  1  22 20 1  20 1  1  1  1  1  20 20 20 20 1  1  1  1  1  1  1  1  1  1  1  20
20 20 20 20 21 20 20 1  1  20 20 22 1  1  22 20 20 1  20 1  1  1  1  1  1  20 20 20 1  22 22 22 22 22 22 22 22 22 1  20
20 22 22 1  1  22 20 1  1  1  20 20 1  1  20 20 1  1  20 20 1  1  1  1  1  1  20 20 1  1  1  1  1  1  1  1  1  1  1  20
20 22 22 1  22 22 20 20 21 21 20 20 1  1  20 1  1  1  1  20 20 1  1  1  1  1  22 20 20 1  1  1  1  22 1  1  1  1  1  20
20 22 22 1  22 22 20 20 1  1  1  20 1  1  20 1  1  1  1  21 21 1  1  1  1  1  22 20 20 1  1  1  1  22 1  1  1  1  1  20
20 22 1  1  22 20 20 22 1  1  1  20 1  1  20 1  1  1  20 20 20 1  1  1  1  1  22 20 20 1  1  1  1  22 1  1  1  1  1  20
20 22 1  22 22 20 22 1  1  22 20 20 21 21 20 20 1  1  1  20 20 1  1  1  1  1  1  1  27 1  1  22 22 22 22 22 1  1  1  20 
20 22 1  1  22 20 1  1  22 20 20 22 1  1  22 20 20 1  1  1  20 1  1  1  1  1  22 20 20 1  1  1  1  22 1  1  1  1  1  20
20 20 20 1  20 20 20 23 20 20 22 1  1  1  1  22 20 1  1  1  20 1  1  1  1  1  22 20 20 1  1  1  1  22 1  1  1  1  1  20
20 1  1  1  1  1  20 1  20 20 1  1  1  1  1  22 20 1  21 1  20 1  1  1  1  1  22 20 20 1  1  1  1  22 1  1  1  1  1  20
20 1  20 20 20 1  20 1  20 20 1  1  1  1  1  22 20 1  1  1  20 20 1  1  1  1  20 20 1  1  1  1  1  1  1  1  1  1  1  20
20 1  20 20 20 1  20 1  20 20 1  1  1  1  22 20 20 1  1  1  20 20 25 26 25 20 20 22 1  1  1  1  1  1  1  1  1  1  22 20
20 1  1  1  1  1  20 1  20 20 1  1  1  22 20 20 20 20 1  1  1  20 20 20 20 20 20 22 1  1  1  1  1  1  1  1  1  1  22 20    
20 20 20 1  20 20 20 1  20 20 1  1  22 20 20 20 20 20 20 1  21 1  20 20 20 20 20 22 1  1  1  28 28 28 28 1  1  1  22 20 
20 20 1  1  1  1  1  1  20 20 1  1  20 20 20 20 20 20 20 20 1  1  1  20 20 20 20 22 1  1  1  28 28 28 28 1  1  1  22 20
20 1  1  1  1  20 20 20 20 20 20 23 20 20 20 20 20 20 20 20 20 20 1  20 20 20 20 22 1  1  1  28 28 28 28 1  1  1  22 20 
20 20 1  1  20 20 20 20 20 20 20 1  1  1  1  1  1  1  1  1  1  1  1  20 20 20 20 22 22 22 22 22 22 22 22 22 22 22 22 20 
20 20 20 20 20 20 20 20 20 20 20 20 20 20 20 20 20 20 20 20 20 20 20 20 20 20 20 20 20 20 20 20 20 20 20 20 20 20 20 20 
20 20 20 20 20 20 20 20 20 20 20 20 20 20 20 20 20 20 20 20 20 20 20 20 20 20 20 20 20 20 20 20 20 20 20 20 20 20 20 20  
